#domain
hospital
#levelname
MAPF02
#colors
blue: 0,1,A,2,B
#initial
+++++++++++++
+      BA  1+
+ +++++++++++
+       0   +
+ +++++++++ +
+         +2+
+++++++++++++
#goal
+++++++++++++
+         A +
+ +++++++++++
+      B    +
+ +++++++++ +
+   0     + +
+++++++++++++
#end
