#domain
hospital
#levelname
MAPF02
#colors
blue: 0,1,2,3
#initial
+++++++++++++
+0          +
+         +++
+        21 +
+         + +
+         + +
+++++++++++++
#goal
+++++++++++++
+           +
+         +++
+           +
+         + +
+         +0+
+++++++++++++
#end
