#domain
hospital
#levelname
SAD1
#colors
blue: 0,1,2, A
#initial
+++++++++++++++++++
+0   1    2       +
+              ++++
+                 +
+              ++A+
+               + +
+++++++++++++++++++
#goal
+++++++++++++++++++
+                 +
+              ++++
+                 +
+              ++ +
+               +A+
+++++++++++++++++++
#end
