#domain
hospital
#levelname
SAD1
#colors
blue: 0, A, B
pink: 1
#initial
+++++++++++++++++++
+++++++++1 ++++++++
+ 0A        B     +
+++++++++ +++++++++
+++++++++++++++++++
#goal
+++++++++++++++++++
+++++++++  ++++++++
+B               A+
+++++++++ +++++++++
+++++++++++++++++++
#end
