#domain
hospital
#levelname
SAD2
#colors
blue: 0, A, 1
#initial
+++++++++++++++++++
+0A              1+
+AA            ++++
+                 +
+              ++A+
+               + +
+++++++++++++++++++
#goal
+++++++++++++++++++
+                 +
+              ++++
+                 +
+              ++ +
+A              +A+
+++++++++++++++++++
#end
