#domain
hospital
#levelname
SAD3
#colors
blue: 0, A, 1
#initial
+++++++++++++++++++
+0AA             1+
+AAA           ++++
+A                +
+              ++A+
+               + +
+++++++++++++++++++
#goal
+++++++++++++++++++
+                 +
+              ++++
+                 +
+              ++ +
+               +A+
+++++++++++++++++++
#end
