#domain
hospital
#levelname
SADCorridor
#colors
blue: 0, A, 1, B
#initial
+++++++++++++++++++
+++++++++ +++++++++
+0A               +
+++++++++1+++++++++
+++++++++++++++++++
#goal
+++++++++++++++++++
+++++++++ +++++++++
+                A+
+++++++++ +++++++++
+++++++++++++++++++
#end